111111111111111111111111111111111111111111111111111111111111111111111111111
100000000000000010000000001000001000000000100000000000000000100000100000101
101111111011101110101111111110111011111011101110111011101010101111101111101
100000001000100000100000100010000000001000001010001000101010100000000000001
111011101111111011111111101110111111111111101011111010101111101111111111111
100000100000001000001510000000000000000000100010001010100000100000000000001
111010111111111010101010111110101111111111111110111111111111101011111111111
100010100000001010100000000010100000100000001000000000000010101010000000001
101010101111101111101011111111111111101111101011111011111110101010111111111
101010000000100000101000000000000000000000100000001010000010001000000000001
101010111110111110111110101010101010111011101110111110101110111111111111101
101010000010000010000010101010101010001000100010000000100000000000000000101
101010101011111111111111101011101010111011111011101011101011101111111011111
101010101000000000000000101010101010001000001000101000101010100000001000001
101010111111111110101111111110101110101010101111101111111010111110101111101
101010000000100010100000000000100010101010100000100000001000000010101010101
101110101111101111111010111110101110101011101111111111111010111111111010111
101000100010000000101010000010101000101000100010000000101010000000000000001
101010111110111110101110111110111111101111101110111110101010101110101110111
101010000000100010000010100010100000100000101000000010001010100010100010101
101011101011101111111010101111101111101010111011101111101111111110111111101
101010001000001010001010000000001000101010000000100000100000000010100000001
101110101110111010111011101011111010101111101011111011111111111111101011101
100010100010000000001000101000100010100000101000001000000010000000001000101
111010101010101010101111101111101111111111111110101111111110111111111011111
100010101010101010100000100000001000000000000010100000000000000000001000101
111011101111101111111111101010111011111110101110101011111111111111111111101
100000101000100000000010001010000000100410100010101000000000001000001000101
101111111011101110101111101111111111101111111010111111111111111011111110101
100000000000100010100010000000000000000000001010000000000000000000100010001
101011101010111111111011101011111110111110111010101010111110111010111011101
101000101010000000001010001000001010000010001010101010000010001010000000001
101010111110101010111111101111101011111011111111111010111110111110111011101
101010001000101010100000101000000005001000100000001010000010000010001000101
101110111011111011101110111110101011111011111011111010111011101010101011111
100010001000100000100010000010101000001010000000001010101000101010101000001
101011111111111011101111111111111010111110111111111110101111111111111011111
101000000000100000000000000010000010000000000000000010000000000000001000001
11111111111111111111111111111111111111111111111111111111111111111111111110