111111111111111111111111111111111111111111111111111111111111111111111111111
100000100000100000000010000000000010101010000000101010000000000004000000101
101114101111101111111110111010111110101010111110101013111111111111111111101
100010040010000000000010001010000000000000000010100000001000000000100000001
101011111110111110101110111111111111111111111011101110101011111011101011101
101000000000000010100000000000000000100000001000000010101010001010101010101
101010101111101111111111111111101111101110111011111111111010111110111010111
101010100000100000000000100010100000000010001000000010100000001000000000001
101111111010111010111111101110111111101111111111111110111010111011111110111
100000001010001010000000000000100010000010000000000000000010000000000010001
101110101111111111101111111111101111111010111111111110111011101011101111101
100010100000001000100000000000001000001010000000001010051000101000100000101
101111111010111011101111111011111011111110111110101011111115101111111111111
100000001010000000100000001000000000001000000010100000001010100010000000101
101111111011111111111111101110111011111011111110111111111011111111101111101
100000001000000500000000100010001000000010000010100000001010101000000000001
101011111010111010101010111011101011101110111110101011111010101011111111111
101010000010100210101010101000101010000000001010041010100000000010000000001
101010101011101011101110101011111010101010101011111110101111111110111111111
101010101000101000100010001000101010101010100010000000000000000000100000001
101010111011111010101111111111101111111010111110101111101111101011101111111
101010100000001010100000000000100010001010000000100010000000101000000000001
101011101011101011111111111111101110111111111011111110101110111011111010111
101012001000101000000000000000000000000000001000001000100010100000001010001
111010111010101010111111101110101011111111111011111110111111101011111110101
100010100010101010000040100010101000000000001000000010000010001000000010101
101111101010111110101111111111101111111111101010101011101111101010101111111
101000001010001000100000000000100000000000101010101000100010001010100000001
101110101011101010101110111011101011101111101011111111111111101111111111101
101000101000101010100010100000101010101000101000001010100000101014000000151
101010101011101010101010101011111110111011111111111010101111111010111110111
101010101010001010101010101010000000000000000000101010101010000000100010001
101110111111101111101011101010111010101111101111101010101010111111101111101
101000000000100000101000101000101010100000101000100000000000000010000000101
101110111110111110111010101011101111111011111011111011111110111110111011111
101000001000000010001010101000000000001000000000000000000010001010001000001
101011111110111110111111111110111011101111101110101011101010111010111011111
101000001000000010100000000000001000100000100010101000101010000000001000001
11111111111111111111111111111111111111111111111111111111111111111111111110